  2700  2700 -3000  2850  2860 -3000  2880  2880  2880  2880  2880
  2710  2710 -3000  2850  2860  2870  2880  2890  2890  2890  2890
  2720  2720 -3000  2850  2860 -3000  2880  2890  2900  2900  2900
  2730  2730 -3000  2850  2850 -3000  2880  2890  2900  2910  2910
  2740  2740 -3000  2840  2840 -3000 -3000 -3000 -3000 -3000  2920
  2750  2750 -3000  2830  2830 -3000  2940  2940  2940  2930  2920
  2760  2760 -3000  2820  2820 -3000  2950  2950  2940  2930  2920
  2770  2770 -3000  2810  2810 -3000  2960 -3000 -3000 -3000 -3000
  2770  2780 -3000  2800  2800 -3000  2960  2970  2980  2980  2980
  2770  2780  2790  2790  2790 -3000  2960  2970  2980  2990  2990
  2770  2780 -3000  2780  2780 -3000  2960  2970  2980  2990  3000
